{
	"title": "The Original Maze",
	"author": "Ech <ech@ech.net>",
	"plan": [
		"# #####################################",
		"# #           ##   #  ##   #   #      #",
		"# ###########  ###   # # # # # ## # ###",
		"#               ####         #  #     #",
		"########  #####  ##  ############ #####",
		"#             # ### ##^               #",
		"# ########### # ##  # ######## ##### ##",
		"#  #       ## #  ## # #          #    #",
		"## # ########## ###   # ########## ####",
		"#  # # # #    # ### # # #             #",
		"# ## #     # ##     # # # ###### ### ##",
		"#  # ####### # # ## #   # # #  # # # ##",
		"##               #     #       ###    #",
		"#######################################"
	]
}
