{
	"title": "Figure 8",
	"author": "Ech <ech@ech.net>",
	"plan": [
		"#######################################",
		"#                  ####################",
		"# ################ ####################",
		"# ################ ####################",
		"# ################ ####################",
		"# ################ ####################",
		"#                 ^                   #",
		"################## ################## #",
		"################## ################## #",
		"################## ################## #",
		"################## ################## #",
		"##################                    #",
		"#######################################"
	]
}
