{
	"title": "A Harder One",
	"author": "Ech <ech@ech.net>",
	"plan": [
		"####################################",
		"#^  ##    ##      #                #",
		"#   ## ##    #### # ### #### ##### #",
		"###    #### ##  # #   # #### ##### #",
		"# ####### # #  ## ### #          # #",
		"# ####    # #       # ## ####### # #",
		"#   ## #### ######### ## #         #",
		"###         #         ## # #########",
		"# ## ###### # ########## # #       #",
		"# ## # #    # ####    ## # # ##### #",
		"# ## # # #### #### ## ## # # #   # #",
		"# ## # # # ## #    ##      # # # # #",
		"#    #   #  # ## ## ######## # # # #",
		"# #### # ##   ## ##       ## # # # #",
		"#      # ## #### #### ### ## # # # #",
		"# ######    #### #### ###    # # # #",
		"#      ######         ######## # # #",
		"############# ###########      # # #",
		"#     #   #   #   #   ########## # #",
		"# ### # #   #   #   #          # # #",
		"# ### # # #################### # # #",
		"  ### # #                #     # # #",
		"# ### # # ############## # # ### # #",
		"#     # # #            # # #   # # #",
		"### ###   # ####### ## #   #  ## # #",
		"### ####### #       ## ######### # #",
		"##          ##########             #",
		"####################################"
	]
}
