{
    "title": "Living Room",
    "author": "michael@keirnan.com",
    "plan": [
        "#################",
        "      ######    #",
        "#     # TV #    #",
        "#     ######    #",
        "#               #",
        "#               #",
        "#                ",
        "#                ",
        "#               #",
        "#               #",
        "        ^       #",
        "#################"
    ]
}
