# #############################################
# #               ##   #  ##   #####          #
# ###############  ###   # # # #   ##### # ####
#                    ###         #  #         #
############  #####  ##  ############# ########
#                 #  ## ##^                   #
# ##############  #  ##  # ######## ######## ##
#  #          ##  #  ### # #            #     #
## #  #############  ###   # ############ #####
#  #  # # # #    ##  #   # # #                #
# ##  #       # ## #   # # # # ############# ##
#  ## ######### #  #  ## #   # # #     # # # ##
##                    #  # #       # #        #
###############################################
