# #############################################
# #               ###### ###########          #
#  #############    ##     ##############   ###
#                     #             #         #
############  #####   #  ######################
#                 #   #  #^                   #
#  ############   #   #  # ######## ######## ##
#  #          #   #   #  # #            #     #
#  #  #############   #    # ############ #####
#  #    #         #      # # #                #
#  #  #       #  # #  #  # # # #############  #
#  #  #########  #    #  # # # #           #  #
#                     #  # #                  #
###############################################
