# #########################################
# #             ##   #  ##   #####        #
# #############  ###   # # # #   #### # ###
#                   ###         #  #      #
##########  #####  ##  ############# ######
#               #  ## ##^                 #
# ############  #  ##  # ######## ####### #
#  #         #  #  ### # #            #   #
## # #############  ###   # ########### ###
#  # # # # #    ##  #   # # #             #
# ## #       # ## #   # # # # ########## ##
#  # ######### #  #  ## #   # #   #   #   #
##                   #  # #     #   #   # #
###########################################
