# ######################################
# #            ##   #  ##   #####      #
# ############  ###   # # # #   ## # ###
#                 ###         #  #     #
#########  #####  ##  ############ #####
#              #  ## ##^               #
# ############ # ##  # ######## ##### ##
#  #        ## #  ## # #          #    #
## #  ########## ###   # ########## ####
#  #  # # #    # ### # # #             #
# ##  #     # ##     # # # ###### ### ##
#  ## ####### # # ## #   # # #  # # # ##
##                #     #       ###    #
########################################
