# #####################################
# #           ##   #  ##   #   #      #
# ###########  ###   # # # # # ## # ###
#               ####         #  #     #
########  #####  ##  ############ #####
#             # ### ##^               #
# ########### # ##  # ######## ##### ##
#  #       ## #  ## # #          #    #
## # ########## ###   # ########## ####
#  # # # #    # ### # # #             #
# ## #     # ##     # # # ###### ### ##
#  # ####### # # ## #   # # #  # # # ##
##               #     #       ###    #
#######################################
